[
	{
		"map": [
			0,0,1,1,1,0,0,0,
			0,1,3,3,1,1,1,1,
			0,1,2,2,3,2,2,1,
			1,2,2,2,1,2,1,0,
			1,2,2,2,2,3,1,0,
			1,2,2,2,2,2,2,1,
			0,1,2,2,2,2,1,0,
			0,0,1,1,1,1,1,0
		],
		"boxPos": [
			{"x":5,"y":3},
			{"x":3,"y":5},
			{"x":2,"y":4},
			{"x":4,"y":5}
		],
		"personPos": {"x":4,"y":6}
	},
	{
		"map": [
			0,0,1,1,1,0,0,0,
			0,1,3,3,1,1,1,1,
			0,1,2,2,2,2,2,1,
			1,2,2,2,1,2,2,1,
			1,2,2,1,2,3,2,1,
			1,2,2,2,2,2,2,1,
			1,3,2,2,2,2,1,0,
			0,1,1,1,1,1,1,0
		],
		"boxPos": [
			{"x":5,"y":3},
			{"x":3,"y":5},
			{"x":2,"y":4},
			{"x":4,"y":5}
		],
		"personPos": {"x":4,"y":6}
	},
	{
		"map": [
			0,0,1,1,1,0,0,0,
			0,1,3,3,1,1,1,1,
			0,1,2,2,2,2,2,1,
			1,2,2,2,1,2,2,1,
			1,2,2,1,2,3,2,1,
			1,2,2,3,2,2,2,1,
			1,3,2,2,2,2,1,0,
			0,1,1,1,1,1,1,0
		],
		"boxPos": [
			{"x":5,"y":3},
			{"x":3,"y":5},
			{"x":2,"y":4},
			{"x":4,"y":5}
		],
		"personPos": {"x":4,"y":6}
	},
	{
		"map": [
			0,0,0,1,1,0,0,0,
			0,1,3,3,1,1,1,1,
			0,1,2,2,2,2,2,1,
			1,2,2,2,1,2,2,1,
			1,2,2,1,2,3,2,1,
			1,2,2,2,2,2,2,1,
			1,3,2,2,2,2,1,0,
			0,1,1,1,1,1,1,0
		],
		"boxPos": [
			{"x":5,"y":3},
			{"x":3,"y":5},
			{"x":2,"y":4},
			{"x":4,"y":5}
		],
		"personPos": {"x":4,"y":6}
	}

]
